1D5R	RAT TYPE II ADENYLYL CYCLASE C2 DOMAIN/FORSKOLIN COMPLEX	Zhang, G.#Hurley, J.H.
1DIY	Crystal Structure of the PTEN Tumor Suppressor	Lee, J.O.#Yang, H.#Georgescu, M.-M.#Di Cristofano, A.#Pavletich, N.P.
1FVR	CRYSTAL STRUCTURE OF ARACHIDONIC ACID BOUND IN THE CYCLOOXYGENASE ACTIVE SITE OF PGHS-1	Malkowski, M.G.#Ginell, S.L.#Smith, W.L.#Garavito, R.M.
1HJ1	TIE2 KINASE DOMAIN	Shewchuk, L.M.#Hassell, A.M.#Ellis, B.#Holmes, W.D.#Davis, R.#Horne, E.L.#Kadwell, S.H.#McKee, D.D.#Moore, J.T.
1I3O	RAT OESTROGEN RECEPTOR BETA LIGAND-BINDING DOMAIN IN COMPLEX WITH PURE ANTIOESTROGEN ICI164,384	Pike, A.C.W.#Brzozowski, A.M.#Carlquist, M.
1L8K	CRYSTAL STRUCTURE OF THE COMPLEX OF XIAP-BIR2 AND CASPASE 3	Riedl, S.J.#Renatus, M.#Schwarzenbacher, R.#Zhou, Q.#Sun, C.#Fesik, S.W.#Liddington, R.C.#Salvesen, G.S.
1NPO	T Cell Protein-Tyrosine Phosphatase Structure	Iversen, L.F.
1PYO	BOVINE NEUROPHYSIN II COMPLEX WITH OXYTOCIN	Rose, J.P.#Wang, B.-C.
1T0J	Crystal Structure of Human Caspase-2 in Complex with Acetyl-Leu-Asp-Glu-Ser-Asp-cho	Schweizer, A.#Briand, C.#Grutter, M.G.
1XNX	Crystal structure of a complex between voltage-gated calcium channel beta2a subunit and a peptide of the alpha1c subunit	Van Petegem, F.#Clark, K.#Chatelain, F.#Minor Jr., D.
1YK0	Crystal structure of constitutive androstane receptor	Fernandez, E.
2AHS	structure of natriuretic peptide receptor-C complexed with atrial natriuretic peptide	He, X.#Garcia, K.C.
2BXS	Crystal Structure of the Catalytic Domain of Human Tyrosine Receptor Phosphatase Beta	Ugochukwu, E.#Eswaran, J.#Barr, A.#Gileadi, O.#Sobott, F.#Burgess, N.#Ball, L.#Bray, J.#von Delft, F.#Debreczeni, J.#Bunkoczi, G.#Turnbull, A.#Das, S.#Weigelt, J.#Edwards, A.#Arrowsmith, C.#Sundstrom, M.#Knapp, S.#Structural Genomics Consortium (SGC)
2C2Z	HUMAN MONOAMINE OXIDASE A IN COMPLEX WITH CLORGYLINE, CRYSTAL FORM B	De Colibus, L.#Binda, C.#Edmondson, D.E.#Mattevi, A.
2C67	Crystal structure of caspase-8 in complex with aza-peptide Michael acceptor inhibitor	Ganesan, R.#Jelakovic, S.#Ekici, O.D.#Li, Z.Z.#James, K.E.#Asgian, J.L.#Campbell, A.J.#Mikolajczyk, J.#Salvesen, G.S.#Powers, J.C.#Gruetter, M.G.
2HI4	MAO INHIBITION BY RASAGILINE ANALOGUES	Binda, C.#Hubalek, F.#Li, M.#Herzig, Y.#Sterling, J.#Edmondson, D.E.#Mattevi, A.
2I75	Crystal Structure of Human Microsomal P450 1A2 in complex with alpha-naphthoflavone	Sansen, S.#Yano, J.K.#Reynald, R.L.#Schoch, G.S.#Stout, C.D.#Johnson, E.F.
2NLK	Crystal Structure of Human Protein Tyrosine Phosphatase N4 (PTPN4)	Ugochukwu, E.#Barr, A.#Savitsky, P.#Burgess, N.#Das, S.#Turnbull, A.#von Delft, F.#Sundstrom, M.#Edwards, A.#Arrowsmith, C.#Weigelt, J.#Knapp, S.#Structural Genomics Consortium (SGC)
2QR9	Crystal structure of D1 and D2 catalytic domains of human Protein Tyrosine Phosphatase Gamma (D1+D2 PTPRG)	Filippakopoulos, P.#Gileadi, O.#Johansson, C.#Ugochukwu, E.#Edwards, A.#Arrowsmith, C.#Sundstrom, M.#von Delft, F.#Knapp, S.#Structural Genomics Consortium (SGC)
2QYK	Crystal Structure of the Estrogen Receptor Alpha Ligand Binding Domain Complexed with an Oxabicyclic Derivative Compound	Nettles, K.W.#Bruning, J.B.
2V5Y	Crystal structure of PDE4A10 in complex with inhibitor NPV	Wang, H.#Peng, M.#Chen, Y.#Geng, J.#Robinson, H.#Houslay, M.
2XWT	CRYSTAL STRUCTURE OF THE RECEPTOR PROTEIN TYROSINE PHOSPHATASE MU ECTODOMAIN	Aricescu, A.R.#Siebold, C.#Choudhuri, K.#Chang, V.T.#Lu, W.#Davis, S.J.#Van Der Merwe, P.A.#Jones, E.Y.
2Y6C	CRYSTAL STRUCTURE OF THE TSH RECEPTOR IN COMPLEX WITH A BLOCKING TYPE TSHR AUTOANTIBODY	Sanders, J.#Sanders, P.#Young, S.#Kabelis, K.#Baker, S.#Sullivan, A.#Evans, M.#Clark, J.#Wilmot, J.#Hu, X.#Roberts, E.#Powell, M.#Nunez Miguel, R.#Furmaniak, J.#Rees Smith, B.
2Z5X	THE DISCOVERY OF MMP7 INHIBITORS EXPLOITING A NOVEL SELECTIVITY TRIGGER	Edman, K.#Furber, M.#Hemsley, P.#Johansson, C.#Pairaudeau, G.#Petersen, J.#Stocks, M.#Tervo, A.#Ward, A.#Wells, E.#Wissler, L.
3AYU	Crystal Structure of Human Monoamine Oxidase A with Harmine	Son, S.Y.#Ma, J.#Yoshimura, M.#Tsukihara, T.
3EHS	Crystal structure of MMP-2 active site mutant in complex with APP-drived decapeptide inhibitor	Hashimoto, H.#Takeuchi, T.#Komatsu, K.#Miyazaki, K.#Sato, M.#Higashi, S.
3F81	Crystal structure of the extracellular domain of human corticotropin releasing factor receptor type 1 (CRFR1)	Pioszak, A.A.#Xu, H.E.
3F96	Interaction of VHR with SA3	Wu, S.#Mutelin, T.#Tautz, L.
3HIL	Crystal structure of human plasma platelet activating factor acetylhydrolase covalently inhibited by sarin	Samanta, U.#Bahnson, B.J.
3IBD	SAM Domain of Human Ephrin Type-A Receptor 1 (EphA1)	Walker, J.R.#Yermekbayeva, L.#Butler-Cole, C.#Weigelt, J.#Bountra, C.#Arrowsmith, C.H.#Edwards, A.M.#Bochkarev, A.#Dhe-Paganon, S.#Structural Genomics Consortium (SGC)
3KN5	Crystal structure of a cytochrome P450 2B6 genetic variant in complex with the inhibitor 4-(4-chlorophenyl)imidazole	Gay, S.C.#Sun, L.#Talakad, J.C.#Shah, M.B.#Stout, D.C.#Halpert, J.R.
3LVP	Crystal structure of the C-terminal kinase domain of msk1 in complex with AMP-PNP	D'Angelo, I.#Malakhova, M.#Dong, Z.
3M2W	Crystal structure of bisphosphorylated IGF1-R Kinase domain (2P) in complex with a bis-azaindole inhibitor	Maignan, S.#Marquette, J.P.#Guilloteau, J.P.
3NWE	Crystal structure of MAPKAK kinase 2 (MK2) complexed with a spiroazetidine-tetracyclic ATP site inhibitor	Kroemer, M.#Revesz, L.#Be, C.#Izaac, A.#Huppertz, C.#Schlapbach, A.#Scheufler, C.
3NYA	Rat COMT in complex with a methylated desoxyribose bisubstrate-containing inhibitor avoids hydroxyl group	Ehler, A.#Schlatter, D.#Stihle, M.#Benz, J.#Rudolph, M.G.
3OMV	Crystal structure of the human beta2 adrenergic receptor in complex with the neutral antagonist alprenolol	Brown, M.A.#Wacker, D.#Fenalti, G.#Katritch, V.#Abagyan, R.#Cherezov, V.#Stevens, R.C.#GPCR Network (GPCR)
3QN1	Crystal structure of c-raf (raf-1)	Hatzivassiliou, G.#Song, K.#Yen, I.#Brandhuber, B.J.#Anderson, D.J.#Alvarado, R.#Ludlam, M.J.#Stokoe, D.#Gloor, S.L.#Vigers, G.P.A.#Morales, T.#Aliagas, I.#Liu, B.#Sideris, S.#Hoeflich, K.P.#Jaiswal, B.S.#Seshagiri, S.#Koeppen, H.#Belvin, M.#Friedman, L.S.#Malek, S.
3SHI	Crystal structure of the PYR1 Abscisic Acid receptor in complex with the HAB1 type 2C phosphatase catalytic domain	Betz, K.#Dupeux, F.#Santiago, J.#Marquez, J.A.
3SQ9	Crystal structure of human MMP1 catalytic domain at 2.2 A resolution	Bertini, I.#Calderone, V.#Cerofolini, L.#Fragai, M.#Geraldes, C.F.G.C.#Hermann, P.#Luchinat, C.#Parigi, G.#Teixeira, J.
3ZFM	Crystal Structures of the Ligand Binding Domain of a Pentameric Alpha7 Nicotinic Receptor Chimera	Li, S.-X.#Huang, S.#Bren, N.#Noridomi, K.#Dellisanti, C.#Sine, S.#Chen, L.
4A69	Crystal structure of EphB2	Debreczeni, J.E.#Overman, R.#Truman, C.#McAlister, M.#Attwood, T.K.
4AGD	Structure of HDAC3 bound to corepressor and inositol tetraphosphate	Watson, P.J.#Fairall, L.#Santos, G.M.#Schwabe, J.W.R.
4BSK	CRYSTAL STRUCTURE OF VEGFR2 (JUXTAMEMBRANE AND KINASE DOMAINS) IN COMPLEX WITH SUNITINIB (SU11248) (N-2-diethylaminoethyl)-5-((Z)-(5- fluoro-2-oxo-1H-indol-3-ylidene)methyl)-2,4-dimethyl-1H-pyrrole-3- carboxamide)	Mctigue, M.#Deng, Y.#Ryan, K.#Brooun, A.#Diehl, W.#Stewart, A.
4CRT	Crystal structure of VEGF-C in complex with VEGFR-3 domains D1-2	Leppanen, V.M.#Tvorogov, D.#Kisko, K.#Prota, A.E.#Jeltsch, M.#Anisimov, A.#Markovic-Mueller, S.#Stuttfeld, E.#Goldie, K.N.#Ballmer-Hofer, K.#Alitalo, K.
4D10	Crystal structure of human monoamine oxidase B in complex with the multi-target inhibitor ASS234	Esteban, G.#Allan, J.#Samadi, A.#Mattevi, A.#Unzeta, M.#Marco-Contelles, J.#Binda, C.#Ramsay, R.R.
4DEY	Crystal structure of the COP9 signalosome	Bunker, R.D.#Lingaraju, G.M.#Thoma, N.H.
4DJH	Crystal structure of the Voltage Dependent Calcium Channel beta-2 Subunit in Complex With The CaV1.2 I-II Linker.	Almagor, L.#Hirsch, J.A.
4EKK	Structure of the human kappa opioid receptor in complex with JDTic	Wu, H.#Wacker, D.#Katritch, V.#Mileni, M.#Han, G.W.#Vardy, E.#Liu, W.#Thompson, A.A.#Huang, X.P.#Carroll, F.I.#Mascarella, S.W.#Westkaemper, R.B.#Mosier, P.D.#Roth, B.L.#Cherezov, V.#Stevens, R.C.#GPCR Network (GPCR)
4ETM	Akt1 with AMP-PNP	Wu, W.-I.#Vigers, G.P.A#Morales, T.H.#Brandhuber, B.J.
4G9L	Crystal structure of YfkJ from Bacillus subtilis	Cao, X.F.#Su, X.D.
4GE2	Structure of MMP3 complexed with NNGH inhibitor.	Belviso, B.D.#Arnesano, F.#Calderone, V.#Caliandro, R.#Natile, G.#Siliqi, D.
4GPO	Crystal structure of human protein tyrosine phosphatase PTPN9 (MEG2) complex with compound 3	Zhang, Z.-Y.#Liu, S.#Zhang, S.
4GQS	Oligomeic Turkey Beta1-Adrenergic G Protein-Coupled Receptor	Huang, J.J.#Chen, S.#Zhang, J.J.#Huang, X.Y.
4GRY	Structure of Human Microsomal Cytochrome P450 (CYP) 2C19	Reynald, R.L.#Sansen, S.#Stout, C.D.#Johnson, E.F.
4GV1	Crystal structure of SHP1 catalytic domain with SO4	Alicea-Velazquez, N.L.#Jakoncic, J.#Boggon, T.J.
4HGT	PKB alpha in complex with AZD5363	Addie, M.#Ballard, P.#Bird, G.#Buttar, D.#Currie, G.#Davies, B.#Debreczeni, J.#Dry, H.#Dudley, P.#Greenwood, R.#Hatter, G.#Jestel, A.#Johnson, P.D.#Kettle, J.G.#Lane, C.#Lamont, G.#Leach, A.#Luke, R.W.A.#Ogilvie, D.#Page, K.#Pass, M.#Steinbacher, S.#Steuber, H.#Pearson, S.#Ruston, L.
4HKR	Crystal structure of ck1d with compound 13	Huang, X.
4I8V	Calcium release-activated calcium (CRAC) channel ORAI	Long, S.B.#Hou, X.
4IAQ	Human Cytochrome P450 1A1 in complex with alpha-naphthoflavone	Walsh, A.A.#Scott, E.E.
4IYP	Crystal structure of the chimeric protein of 5-HT1B-BRIL in complex with dihydroergotamine (PSI Community Target)	Wang, C.#Jiang, Y.#Ma, J.#Wu, H.#Wacker, D.#Katritch, V.#Han, G.W.#Liu, W.#Huang, X.#Vardy, E.#McCorvy, J.D.#Gao, X.#Zhou, E.X.#Melcher, K.#Zhang, C.#Bai, F.#Yang, H.#Yang, L.#Jiang, H.#Roth, B.L.#Cherezov, V.#Stevens, R.C.#Xu, H.E.#GPCR Network (GPCR)
4JP4	structure of the nPP2Ac-alpha4 complex	Jiang, L.#Stanevich, V.#Satyshur, K.A.#Xing, Y.
4LNW	Mmp13 in complex with a reverse hydroxamate Zn-binder	Gerhardt, S.#Hargreaves, D.
4MQE	Crystal structure of TR-alpha bound to T3 in a second site	Puhl, A.C.#Aparicio, R.#Polikarpov, I.
4MQS	Crystal structure of the extracellular domain of human GABA(B) receptor in the apo form	Geng, Y.#Bush, M.#Mosyak, L.#Wang, F.#Fan, Q.R.
4MS3	Structure of active human M2 muscarinic acetylcholine receptor bound to the agonist iperoxo	Kruse, A.C.#Ring, A.M.#Manglik, A.#Hu, J.#Hu, K.#Eitel, K.#Huebner, H.#Pardon, E.#Valant, C.#Sexton, P.M.#Christopoulos, A.#Felder, C.C.#Gmeiner, P.#Steyaert, J.#Weis, W.I.#Garcia, K.C.#Wess, J.#Kobilka, B.K.
4NZ2	Crystal structure of the extracellular domain of human GABA(B) receptor bound to the endogenous agonist GABA	Geng, Y.#Bush, M.#Mosyak, L.#Wang, F.#Fan, Q.R.
4OAR	Crystal structure of CYP2C9 in complex with an inhibitor	Branden, G.#Sjogren, T.#Xue, Y.
4OEW	Progesterone receptor with bound ulipristal acetate and a peptide from the co-repressor SMRT	Petit-Topin, I.#Fay, M.R.#Resche-Rigon, M.#Ulmann, A.#Gainer, E.#Rafestin-Oblin, M.-E.#Fagart, J.
4OIV	Crystal structure of the PDE5A1 catalytic domain in complex with novel inhibitors	Chen, T.T.#Ren, J.#Xu, Y.C.
4OR2	Structural basis for small molecule NDB as a selective antagonist of FXR	Xu, X.#Chen, L.#Hu, L.#Shen, X.
4PIR	Human class C G protein-coupled metabotropic glutamate receptor 1 in complex with a negative allosteric modulator	Wu, H.#Wang, C.#Gregory, K.J.#Han, G.W.#Cho, H.P.#Xia, Y.#Niswender, C.M.#Katritch, V.#Cherezov, V.#Conn, P.J.#Stevens, R.C.#GPCR Network (GPCR)
4PVG	X-ray structure of the mouse serotonin 5-HT3 receptor	Hassaine, G.#Deluz, C.#Grasso, L.#Wyss, R.#Tol, M.B.#Hovius, R.#Graff, A.#Stahlberg, H.#Tomizaki, T.#Desmyter, A.#Moreau, C.#Li, X.-D.#Poitevin, F.#Vogel, H.#Nury, H.
4QTB	Crystal structure of protein tyrosine phosphatase Shp2 catalytic domain complex with small molecular compound L88N79	Zhang, Z.-Y.#Zeng, L.#Liu, D.#Yu, Z.
4R7H	Structure of human ERK1 in complex with SCH772984 revealing a novel inhibitor-induced binding pocket	Chaikuad, A.#Keates, T.#von Delft, F.#Arrowsmith, C.H.#Edwards, A.M.#Bountra, C.#Knapp, S.#Structural Genomics Consortium (SGC)
4RUI	Crystal structure of FMS KINASE domain with a small molecular inhibitor, PLX3397	Zhang, Y.#Zhang, K.#Zhang, C.
4RWA	Crystal structure of a cytochrome P450 2A6 in complex with a monoterpene - sabinene.	Shah, M.B.#Stout, C.D.#Halpert, J.R.
4TK1	Synchrotron structure of the human delta opioid receptor in complex with a bifunctional peptide (PSI community target)	Fenalti, G.#Zatsepin, N.A.#Betti, C.#Giguere, P.#Han, G.W.#Ishchenko, A.#Liu, W.#Guillemyn, K.#Zhang, H.#James, D.#Wang, D.#Weierstall, U.#Spence, J.C.H.#Boutet, S.#Messerschmidt, M.#Williams, G.J.#Gati, C.#Yefanov, O.M.#White, T.A.#Oberthuer, D.#Metz, M.#Yoon, C.H.#Barty, A.#Chapman, H.N.#Basu, S.#Coe, J.#Conrad, C.E.#Fromme, R.#Fromme, P.#Tourwe, D.#Schiller, P.W.#Roth, B.L.#Ballet, S.#Katritch, V.#Stevens, R.C.#Cherezov, V.#GPCR Network (GPCR)
4TZI	Geph E in complex with a GABA receptor alpha3 subunit derived peptide in space group P21212	Kasaragod, V.B.#Maric, H.M.#Schindelin, H.
4U14	Structure of unliganded Lyn SH2 domain	Wybenga-Groot, L.E.
4W4W	Structure of the M3 muscarinic acetylcholine receptor bound to the antagonist tiotropium crystallized with disulfide-stabilized T4 lysozyme (dsT4L)	Thorsen, T.S.#Matt, R.A.#Weis, W.I.#Kobilka, B.K.
4XNU	JNK2/3 in complex with N-(2-methylpyridin-4-yl)-3-{4-[(phenylcarbamoyl)amino]-1H-pyrazol-1-yl}benzamide	Park, H.#Iqbal, S.#Hernandez, P.#Mora, R.#Zheng, K.#Feng, Y.#LoGrasso, P.
4XNV	X-ray structure of Drosophila dopamine transporter in complex with nisoxetine	Aravind, P.#Wang, K.#Gouaux, E.
4ZNX	The human P2Y1 receptor in complex with BPTU	Zhang, D.#Gao, Z.#Jacobson, K.#Han, G.W.#Stevens, R.#Zhao, Q.#Wu, B.
4ZTQ	Crystal structure of the Fyn-SH3 domain in complex with the high affinity peptide APP12	Camara-Artigas, A.
4ZZH	Human Aurora A catalytic domain bound to FK932	Marcaida, M.J.#Kilchmann, F.#Schick, T.#Reymond, J.L.
5A86	SIRT1/Activator Complex	Dai, H.
5A8X	Structure of pregnane X receptor in complex with a Sphingosine 1- Phosphate Receptor 1 Antagonist	Xue, Y.#Oster, L.
5BWN	Crystal Structure of human neutrophil elastase in complex with a dihydropyrimidone inhibitor	vonNussbaum, F.#Li, V.M.#Meibom, D.#Anlauf, S.#Bechem, M.#Delbeck, M.#Gerisch, M.#Harrenga, A.#Karthaus, D.#Lang, D.#Lustig, K.#Mittendorf, J.#Schaefer, M.#Schaefer, S.#Schamberger, J.
5C1M	Crystal Structure of SIRT3 with a H3K9 Peptide Containing a Myristoyl Lysine	Gai, W.#Liu, D.
5CF4	Crystal structure of active mu-opioid receptor bound to the agonist BU72	Huang, W.J.#Manglik, A.#Venkatakrishnan, A.J.#Laeremans, T.#Feinberg, E.N.#Sanborn, A.L.#Kato, H.E.#Livingston, K.E.#Thorsen, T.S.#Kling, R.#Granier, S.#Gmeiner, P.#Husbands, S.M.#Traynor, J.R.#Weis, W.I.#Steyaert, J.#Dror, R.O.#Kobilka, B.K.
5CFB	CRYSTAL STRUCTURE OF JANUS KINASE 2 IN COMPLEX WITH N,N-DICYCLOPROPYL-10-ETHYL-7-[(3-METHOXYPROPYL)AMINO] -3-METHYL-3,5,8,10-TETRAAZATRICYCLO[7.3.0.0,6] DODECA-1(9),2(6),4,7,11-PENTAENE-11-CARBOXAMIDE	Sack, J.S.
5CGC	Crystal Structure of Human Glycine Receptor alpha-3 Bound to Strychnine	Shaffer, P.L.#Huang, X.#Chen, H.
5CXV	Structure of the human class C GPCR metabotropic glutamate receptor 5 transmembrane domain in complex with the negative allosteric modulator 3-chloro-4-fluoro-5-[6-(1H-pyrazol-1-yl)pyrimidin-4-yl]benzonitrile	Christopher, J.A.#Aves, S.J.#Bennett, K.A.#Dore, A.S.#Errey, J.C.#Jazayeri, A.#Marshall, F.H.#Okrasa, K.#Serrano-Vega, M.J.#Tehan, B.G.#Wiggin, G.R.#Congreve, M.
5D6L	Structure of the human M1 muscarinic acetylcholine receptor bound to antagonist Tiotropium	Sun, B.#Feng, D.#Li, X.#Kobilka, T.S.#Kobilka, B.K.
5DDN	beta2AR-T4L - CIM	Ma, P.#Caffrey, M.
5DHH	Crystal structure of GluN1/GluN2A NMDA receptor agonist binding domains with glycine and antagonist, 4-bromophenyl-ACEPC	Mou, T.-C.#Conti, P.#Pinto, A.#Tamborini, L.#Sprang, S.R.#Hansen, K.B.
5DSG	The crystal structure of nociceptin/orphanin FQ peptide receptor (NOP) in complex with SB-612111 (PSI Community Target)	Miller, R.L.#Thompson, A.A.#Trapella, C.#Guerrini, R.#Malfacini, D.#Patel, N.#Han, G.W.#Cherezov, V.#Calo, G.#Katritch, V.#Stevens, R.C.#GPCR Network (GPCR)
5E1S	Structure of the M4 muscarinic acetylcholine receptor (M4-mT4L) bound to tiotropium	Thal, D.M.#Kobilka, B.K.#Sexton, P.M.#Christopoulos, A.
5EEF	The Crystal structure of INSR Tyrosine Kinase in complex with the Inhibitor BI 885578	Kessler, D.#Zahn, S.#Sanderson, M.#Wolkerstorfer, B.
5FMV	Crystal structure of Danio rerio histone deacetylase 6 catalytic domain 1 in complex with trichostatin A	Hai, Y.#Christianson, D.W.
5FNA	Crystal structure of human CD45 extracellular region, domains d1-d4	Chang, V.T.#Fernandes, R.A.#Ganzinger, K.A.#Lee, S.F.#Siebold, C.#McColl, J.#Jonsson, P.#Palayret, M.#Harlos, K.#Coles, C.H.#Jones, E.Y.#Lui, Y.#Huang, E.#Gilbert, R.J.C.#Klenerman, D.#Aricescu, A.R.#Davis, S.J.
5G4C	Cryo-EM reconstruction of caspase-1 CARD	Li, Y.#Lu, A.#Schmidt, F.I.#Yin, Q.#Chen, S.#Fu, T.M.#Tong, A.B.#Ploegh, H.L.#Mao, Y.#Wu, H.
5GLH	Human SIRT2 catalyse short chain fatty acyl lysine	Wang, Y.
5GLJ	Human endothelin receptor type-B in complex with ET-1	Shihoya, W.#Nishizawa, T.#Okuta, A.#Tani, K.#Fujiyoshi, Y.#Dohmae, N.#Nureki, O.#Doi, T.
5HCC	Crystal Structure of PDZ1 Domain of Human Protein Tyrosine Phosphatase PTP-Bas	Lee, S.O.#Ku, B.#Chi, S.W.
5HDE	Ternary complex of human Complement C5 with Ornithodoros moubata OmCI and Dermacentor andersoni RaCI3.	Jore, M.M.#Johnson, S.#Lea, S.M.
5HF5	Crystal Structure of PTPN12 Catalytic Domain	Dong, H.#Li, S.#Shi, J.
5HLN	Crystal structure of human acetylcholinesterase in complex with paraoxon in the unaged state (predominant acyl loop conformation)	Franklin, M.F.#Rudolph, M.J.#Ginter, C.#Cassidy, M.S.#Cheung, J.
5HTI	X-RAY CRYSTAL STRUCTURE OF GSK3B IN COMPLEX WITH CHIR99021	White, A.#Lakshminarasimhan, D.#Nadupalli, A.#Suto, R.K.
5HVU	Crystal structure of c-Met kinase domain in complex with LXM108	Liu, Q.F.#Xu, Y.C.
5HYK	Rho-associated protein kinase 1 (ROCK 1) in complex with a pyridine thiazole piperidine inhibitor	Jacobs, M.J.
5I0B	Crystal structure of the complex PPARalpha/AL26-29	Pochetti, G.#Montanari, R.#Capelli, D.#Loiodice, F.#Laghezza, A.#Lavecchia, A.
5I1B	Structure of PAK4	Park, S.Y.
5I6X	A COMPARISON OF THE HIGH RESOLUTION STRUCTURES OF HUMAN AND MURINE INTERLEUKIN-1B	Ohlendorf, D.H.#Salemme, F.R.
5I9U	X-ray structure of the ts3 human serotonin transporter complexed with paroxetine at the central site	Coleman, J.A.#Green, E.M.#Gouaux, E.
5IAW	Crystal Structure of Ephrin A2 (EphA2) Receptor Protein Kinase	KUDLINZKI, D.#LINHARD, V.L.#GANDE, S.L.#SREERAMULU, S.#SAXENA, K.#HEINZLMEIR, S.#MEDARD, G.#KUESTER, B.#SCHWALBE, H.
5IZF	Novel natural FXR modulator with a unique binding mode	Lu, Y.#Li, Y.
5JFS	Complex of PKA with the bisubstrate protein kinase inhibitor ARC-1408	Pflug, A.#Enkvist, E.#Uri, A.#Engh, R.A.
5K9I	Crystal structure of TrkA in complex with PF-00593174	Jayasankar, J.#Brown, D.#Skerratt, S.#Kurumbail, R.
5KIR	Crystal structure of c-SRC in complex with a covalent lysine probe	Wan, X.#Ouyang, S.#Zhao, Q.#Taunton, J.
5L1B	The Structure of Vioxx Bound to Human COX-2	Orlando, B.J.#Malkowski, M.G.
5L7E	AMPA subtype ionotropic glutamate receptor GluA2 in Apo state	Yelshanskaya, M.V.#Singh, A.K.#Sampson, J.M.#Sobolevsky, A.I.
5LYQ	MCR IN COMPLEX WITH ligand	Edman, K.#Aagaard, A.#Backstrom, S.#Xue, Y.
5M57	Crystal structure of the Retinoic Acid Receptor alpha in complex with a synthetic spiroketal agonist and a fragment of the TIF2 co-activator.	Andrei, S.A.#Ottmann, C.
5MFQ	Nek2 bound to arylaminopurine 6	Bayliss, R.
5NEV	Crystal structure of the GluK1 ligand-binding domain in complex with kainate and BPAM-344 at 1.90 A resolution	Larsen, A.P.#Frydenvang, K.#Kastrup, J.S.
5NGU	CDK2/Cyclin A in complex with compound 73	Coxon, C.R.#Anscombe, E.#Harnor, S.J.#Martin, M.P.#Carbain, B.#Hardcastle, I.R.#Harlow, L.K.#Korolchuk, S.#Matheson, C.J.#Noble, M.E.M.#Newell, D.R.#Turner, D.#Sivaprakasam, M.#Wang, L.Z.#Wong, C.#Golding, B.T.#Griffin, R.J.#Cano, G.
5SW8	Human Erk2 with an Erk1/2 inhibitor	Debreczeni, J.E.#Ward, R.A.#Bethel, P.#Cook, C.#Davies, E.#Eckersley, K.#Fairley, G.#Feron, L.#Flemington, V.#Graham, M.A.#Greenwood, R.#Hopcroft, P.#Howard, T.D.#Hudson, J.#James, M.#Jones, C.D.#Jones, C.R.#Lamont, S.#Lewis, R.#Lindsay, N.#Roberts, K.#Simpson, I.#StGallay, S.#Swallow, S.#Tonge, M.
5T04	Crystal structure of PI3Kalpha in complex with fragments 7 and 11	Gabelli, S.B.#Vogelstein, B.#Miller, M.S.#Amzel, L.M.
5T19	STRUCTURE OF CONSTITUTIVELY ACTIVE NEUROTENSIN RECEPTOR	Krumm, B.#Botos, I.#Grisshammer, R.
5T5T	Structure of PTP1B complexed with N-(3'-(1,1-dioxido-4-oxo-1,2,5-thiadiazolidin-2-yl)-4'-methyl-[1,1'-biphenyl]-4-yl)acetamide	Laciak, A.R.#Tanner, J.J.
5T89	AMPK bound to allosteric activator	Calabrese, M.F.#Kurumbail, R.G.
5T8E	Crystal structure of VEGF-A in complex with VEGFR-1 domains D1-6	Markovic-Mueller, S.#Stuttfeld, E.#Asthana, M.#Weinert, T.#Bliven, S.#Goldie, K.N.#Kisko, K.#Capitani, G.#Ballmer-Hofer, K.
5T90	Synthesis and biological evaluation of novel selective androgen receptor modulators (SARMs). Part II: Optimization of 4-(pyrrolidin-1-yl)benzonitrile derivatives	Wilson, K.P.
5TE8	Structural mechanisms for alpha-conotoxin selectivity at the human alpha3beta4 nicotinic acetylcholine receptor	Abraham, N.#Healy, M.#Ragnarsson, L.#Brust, A.#Alewood, P.#Lewis, R.
5TFT	Crystal structure of the midazolam-bound human CYP3A4	Sevrioukova, I.#Poulos, T.
5TH6	Structure of cytochrome P450 2D6 (CYP2D6) BACE1 inhibitor complex	Hsu, M.H.#Johnson, E.F.
5TQW	Structure determination of a potent, selective antibody inhibitor of human MMP9 (apo MMP9)	Appleby, T.C.#Greenstein, A.E.#Kwon, H.J.
5TTO	CryoEM reconstruction of human IKK1, open conformation 1	Lyumkis, D.#Ghosh, G.#Polley, S.#Biswath, T.#Huang, D.#Passos, D.O.
5TVN	X-ray crystal structure of PPARgamma in complex with SR1643	Bruning, J.B.#Frkic, R.L.#Griffin, P.#Kamenecka, T.#Abell, A.
5U2D	Crystal structure of the LSD-bound 5-HT2B receptor	Wacker, D.#Wang, S.#McCorvy, J.D.#Betz, R.M.#Venkatakrishnan, A.J.#Levit, A.#Lansu, K.#Schools, Z.L.#Che, T.#Nichols, D.E.#Shoichet, B.K.#Dror, R.O.#Roth, B.L.
5U8L	Crystal Structure of the ER-alpha Ligand-binding Domain (Y537S) in complex with Oxabicyclic Heptene Sulfonate (OBHS)	Nwachukwu, J.C.#Erumbi, R.#Nowak, J.#Carlson, K.E.#Katzenellenbogen, J.A.#Izard, T.#Nettles, K.W.
5UEN	Crystal structure of EGFR kinase domain in complex with a sulfonyl fluoride probe XO44	Gajiwala, K.S.#Ferre, R.
5UFS	Crystal structure of the human adenosine A1 receptor A1AR-bRIL in complex with the covalent antagonist DU172 at 3.2A resolution	Glukhova, A.#Thal, D.M.#Nguyen, A.T.#Vecchio, E.A.#Jorg, M.#Scammells, P.J.#May, L.T.#Sexton, P.M.#Christopoulos, A.
5UNF	X-Ray Crystal Structure of the Ancestral Glucocorticoid Receptor 2 ligand binding domain in complex with triamcinolone acetonide and SHP coregulator fragment	Weikum, E.R.#Ortlund, E.A.
5UQ0	XFEL structure of human angiotensin II type 2 receptor (Monoclinic form) in complex with compound 1 (N-benzyl-N-(2-ethyl-4-oxo-3-{[2'-(2H-tetrazol-5-yl)[1,1'-biphenyl]-4-yl])	Zhang, H.#Han, G.W.#Batyuk, A.#Ishchenko, A.#White, K.L.#Patel, N.#Sadybekov, A.#Zamlynny, B.#Rudd, M.T.#Hollenstein, K.#Tolstikova, A.#White, T.A.#Hunter, M.S.#Weierstall, U.#Liu, W.#Babaoglu, K.#Moore, E.L.#Katz, R.D.#Shipman, J.M.#Garcia-Calvo, M.#Sharma, S.#Sheth, P.#Soisson, S.M.#Stevens, R.C.#Katritch, V.#Cherezov, V.
5UWF	FGFR1 kinase domain complex with fragment 2,2-dimethyl-2,3-dihydrobenzofuran-7-carboxamide	Paik, W.-K.#Squire, C.J.
5V0N	Crystal structure of human PDE10A in complex with inhibitor 16d	Xu, R.#Cedervall, E.P.#Sridhar, V.#Barker, R.#Aertgeerts, K.
5VA1	BACE1 in complex with inhibitor 5g	Mesecar, A.#Ghosh, A.#Yen, Y.-C.
5VB8	Cryo-EM structure of the human ether-a-go-go related K+ channel	Wang, W.W.#MacKinnon, R.
5VB8	Crystal structure of the NavAb voltage-gated sodium channel in an open state	Lenaeus, M.J.#Catterall, W.A.
